0100000000000000000
0112222221111110000
0000000001000011130
0000000002000000030
0000000000000000030
1001111001110011110
1000000000000000000
1110000000000000000
1111111113010000001
0000000003110000001
0000000003000000111
0000000001000000000
0000220000000111000
0000001000000000000
2200000000000000000
0000000001200000000
0000001000001111101
1112201000000000001
0000001000000000001
0000001000001111111
0000000220000000000
1100000000000000000
1200000001000000000
0000000111122222000
0000000000000000000
0000110000000000000
0000000000001000000
1010000111100010000
1011110222000000000
1000010000110001000
1000020000000000000
1110000000000000010
0000000000000000000
0001100022210002211
0000000000000000000
0000010010000000001
0000000010100000001
0000000010000100001
0001014100000000100
0000010100011111100
0010010000000001000
0000001111000001000
0100000000001111000
0000000000000000000
1111110000000000000
0000000010011004400
0000000000011000000
0000000000000004400
0001000000009000000
0001111111111111100
0000000000000000000
0000000000000000000
0000000000000000000
0000000000000000000
0000000000000000000